0 0 0 0 0 0 0 12 0 0 0 0 0 0 0 0 0 1 20 13 13 13 15 63 59 17 17 17 64 13 13 13 13 13 13 66 17 17 64 13 13 13 13 13 13 13 13 13 13 13 
0 0 11 0 0 0 0 0 0 0 0 0 11 0 0 0 2 5 20 13 13 15 66 17 18 17 61 65 13 13 13 13 13 13 13 66 17 18 60 63 13 13 13 13 13 13 13 13 13 13 
0 0 0 0 12 0 0 0 0 0 0 0 0 0 2 6 5 22 13 13 13 13 59 17 61 65 13 13 14 13 13 13 13 19 13 66 17 17 17 17 60 13 13 13 13 13 13 13 13 14 
0 0 0 0 0 0 0 12 0 0 0 0 0 2 5 22 23 13 13 13 14 59 17 17 64 14 14 13 13 15 13 13 14 13 13 13 62 17 18 17 17 60 15 13 13 19 13 13 13 13 
2 6 6 6 4 0 0 0 0 0 0 11 2 5 22 13 13 13 13 63 59 17 61 65 13 13 13 13 13 13 13 13 13 13 16 13 13 62 17 17 17 17 60 63 13 13 13 13 13 19 
1 22 23 24 3 0 12 0 0 0 0 0 1 22 13 13 13 13 66 17 18 61 13 13 13 13 19 13 13 13 13 16 13 13 13 13 15 13 62 17 17 18 17 17 60 13 13 15 13 13 
5 20 13 21 3 0 0 2 6 6 6 6 5 20 15 15 13 63 59 17 61 13 13 14 13 13 13 13 13 13 14 13 13 13 13 13 13 13 13 65 62 17 17 17 17 60 13 14 13 13 
63 13 13 21 7 6 6 5 22 23 23 23 23 14 14 13 66 17 17 17 64 13 13 13 13 13 13 13 13 13 13 13 13 13 16 13 13 13 13 13 13 62 17 17 18 17 60 63 13 13 
18 60 63 63 23 23 23 63 63 63 13 13 13 13 13 63 59 17 61 65 13 13 13 13 13 13 13 14 13 13 19 25 30 30 30 28 13 14 13 19 13 13 62 17 17 17 17 17 60 63 
17 17 17 17 60 63 59 17 17 17 60 63 13 13 59 17 18 17 64 13 13 13 19 13 13 15 13 13 13 13 25 32 38 38 38 31 28 13 13 13 13 13 13 65 62 17 17 17 17 17 
62 17 18 17 17 17 18 17 17 17 17 17 60 59 17 17 61 65 13 13 13 13 13 13 13 13 13 14 13 25 32 38 38 38 38 38 31 28 13 13 13 15 13 13 13 65 62 18 18 17 
13 65 62 17 17 17 17 61 65 62 18 17 17 17 17 61 13 13 13 13 13 13 13 13 13 13 13 13 25 32 38 38 38 38 38 38 38 31 28 13 13 13 13 13 19 13 13 65 65 65 
13 13 13 65 65 65 65 13 13 13 65 65 62 17 17 64 13 13 13 13 13 15 13 13 13 13 13 25 32 38 38 38 38 38 38 38 38 38 31 28 13 13 13 13 13 13 13 13 13 13 
8 9 20 13 13 13 13 13 13 13 13 13 21 10 9 20 13 13 13 13 13 13 13 13 13 13 25 32 38 38 38 38 38 38 38 38 38 38 38 31 28 16 13 13 13 14 13 13 19 13 
0 0 9 20 13 13 13 13 13 13 13 13 21 3 1 20 13 13 13 13 13 13 13 13 19 25 32 38 38 38 38 38 38 38 38 38 38 38 38 38 31 28 13 13 13 13 13 16 13 13 
0 0 0 8 8 8 8 8 8 8 8 8 8 0 1 20 13 13 19 13 15 13 13 13 25 32 38 38 38 38 38 38 38 38 38 38 38 38 38 38 38 31 28 13 19 13 13 13 13 13 
0 11 0 0 0 0 0 0 0 0 11 0 0 0 1 20 13 13 13 13 13 13 13 25 32 38 38 38 38 38 34 27 27 27 27 27 27 27 27 36 38 38 31 28 13 13 16 13 16 13 
0 0 0 0 0 12 0 0 0 0 0 0 0 0 1 20 13 13 13 13 13 13 25 32 38 38 38 38 38 38 33 13 13 13 13 13 13 13 13 37 38 38 38 31 28 13 13 13 13 13 
0 0 0 0 0 0 0 0 0 0 0 0 0 0 1 20 13 13 13 15 13 25 32 38 38 38 38 38 38 38 33 13 14 13 13 13 19 13 13 37 38 38 38 38 31 28 13 19 13 13 
0 0 0 0 0 0 0 0 0 0 0 0 0 0 1 20 13 19 13 13 13 57 58 58 58 58 58 58 58 58 58 13 13 13 13 13 13 13 13 37 38 38 38 38 38 31 28 13 13 13 
0 0 0 0 0 0 0 0 0 0 0 0 0 0 1 20 13 13 14 13 13 57 58 58 58 58 58 58 58 58 58 13 15 13 13 13 13 14 13 37 38 38 38 38 38 38 33 13 13 13 
0 0 0 0 0 11 0 0 0 0 0 0 0 0 0 9 20 13 13 13 13 57 58 58 58 58 58 58 58 58 58 13 13 13 13 13 13 13 13 37 38 38 38 38 38 34 13 14 13 13 
0 0 0 0 0 0 0 0 0 0 0 0 0 0 0 1 20 13 13 13 13 13 36 38 38 38 38 38 38 38 33 13 14 13 13 19 13 13 13 37 38 38 38 38 34 13 13 13 13 13 
0 0 0 0 0 0 0 0 0 0 0 0 12 0 0 1 20 14 13 13 13 13 13 36 38 38 38 38 38 38 33 13 13 13 13 13 13 13 15 37 38 38 38 34 13 13 13 19 13 13 
0 0 11 0 0 0 0 0 0 0 11 0 0 0 0 1 20 13 13 13 13 13 13 13 36 38 38 38 38 38 31 30 30 30 30 30 30 30 30 32 38 38 34 13 13 15 13 13 13 13 
0 0 0 0 0 0 0 0 0 0 0 0 0 0 0 1 20 13 13 13 13 13 14 13 13 36 38 38 38 38 38 38 38 38 38 38 38 38 38 38 38 34 13 13 13 13 13 63 63 63 
0 0 0 0 0 0 0 0 0 0 0 0 0 0 0 1 20 13 13 19 13 13 13 13 13 13 36 38 38 38 38 38 38 38 38 38 38 38 38 38 34 13 13 13 13 13 59 17 17 18 
0 11 2 13 13 4 0 0 0 0 0 0 0 0 0 1 20 13 13 13 13 13 63 63 13 13 13 36 38 38 38 38 38 38 38 38 38 38 38 34 13 13 13 14 13 66 18 17 17 17 
2 6 5 13 13 7 6 6 6 4 0 0 12 2 6 5 20 13 14 13 13 59 17 17 64 13 13 13 36 38 38 38 38 38 38 38 38 38 34 13 13 13 13 13 13 66 17 17 61 65 
5 22 23 13 13 23 23 23 24 3 0 0 0 2 22 23 13 13 13 13 59 17 18 17 64 13 13 13 13 36 38 38 38 38 38 38 38 34 13 13 13 13 13 19 13 66 17 17 64 13 
23 13 13 13 13 13 13 13 21 7 4 0 0 2 20 13 13 13 13 59 17 17 61 65 13 13 13 13 13 13 36 38 38 38 38 38 34 13 14 13 13 13 13 13 13 66 17 18 64 19 
63 63 63 63 63 63 63 63 63 24 7 6 6 5 20 13 13 13 59 17 18 18 64 13 13 13 13 13 13 13 13 36 38 38 38 34 13 13 13 13 13 15 13 13 13 66 17 18 64 13 
17 17 18 17 17 17 17 18 17 60 63 63 63 63 63 63 63 59 17 17 61 65 13 13 13 13 13 13 13 13 13 13 36 38 34 13 13 13 13 13 13 13 13 13 14 59 17 17 64 13 
65 65 65 65 65 65 65 62 17 17 17 18 17 17 17 17 17 18 17 61 13 13 13 13 19 13 13 13 13 13 19 13 13 27 13 13 13 13 13 13 13 13 13 63 59 17 18 17 64 14 
41 41 41 42 13 13 13 13 65 65 65 65 65 65 65 65 65 65 65 13 13 13 13 13 13 13 13 13 13 13 13 13 13 13 13 14 13 13 13 13 19 13 66 18 17 17 18 61 13 13 
30 30 30 28 13 13 13 35 30 30 30 28 13 13 13 19 13 13 15 13 14 13 13 13 14 13 13 13 13 13 13 13 13 13 13 13 13 13 14 13 13 63 59 17 17 61 65 13 13 13 
38 38 38 31 30 30 30 32 38 38 38 33 13 13 13 13 13 13 13 13 13 13 13 13 13 13 13 13 13 13 14 13 13 15 13 13 13 13 13 13 59 17 17 17 17 64 15 13 13 13 
38 38 38 38 39 39 39 38 38 38 38 33 13 14 13 13 15 13 13 13 13 13 13 13 13 13 13 14 13 13 13 13 13 13 13 13 13 13 13 59 17 18 17 61 65 13 13 13 13 19 
38 38 38 38 39 39 39 38 38 38 38 33 13 13 13 13 13 13 13 43 41 41 41 44 13 13 13 13 13 15 13 13 13 13 13 13 13 13 59 17 17 61 65 13 13 13 13 13 13 13 
38 38 38 38 39 39 39 38 38 38 38 33 13 13 13 13 13 13 13 49 30 30 30 46 13 13 13 13 13 13 13 13 13 13 13 13 15 59 18 17 61 13 13 13 14 13 13 13 13 13 
38 38 38 34 27 27 27 36 38 38 38 31 30 28 13 13 13 13 19 49 38 38 38 54 41 41 41 41 13 13 41 41 41 41 41 44 66 17 17 61 13 13 13 13 13 13 13 13 15 13 
38 38 38 33 63 63 19 37 38 38 38 38 38 33 13 13 13 13 13 49 38 38 38 31 30 30 30 30 30 30 30 30 30 30 30 46 13 65 65 13 13 13 13 13 13 13 13 13 13 13 
38 34 27 59 17 17 60 13 36 39 39 39 39 33 13 19 13 13 14 49 38 38 38 38 38 38 38 38 38 38 38 38 38 38 38 55 13 13 13 14 13 13 15 13 13 13 13 13 13 13 
38 33 66 17 50 52 17 64 37 39 39 39 39 33 13 13 13 13 13 49 38 38 38 38 38 38 38 38 38 38 38 38 38 38 38 55 13 13 13 19 13 13 13 13 13 13 13 14 13 13 
38 33 66 17 51 53 17 64 37 39 39 39 39 33 47 41 41 41 41 48 38 38 38 38 38 38 38 38 38 38 38 38 38 38 38 55 13 13 13 13 13 13 13 13 13 13 13 13 13 13 
38 33 15 62 17 17 61 13 37 38 38 38 38 31 30 30 30 30 30 32 38 38 38 38 38 38 38 38 38 38 38 38 38 38 38 55 13 13 13 13 13 13 19 13 13 13 15 13 13 13 
38 31 30 28 65 65 35 30 32 38 38 38 38 38 38 38 38 38 38 38 38 38 38 38 38 38 38 38 38 38 38 38 38 38 38 55 13 13 13 15 13 13 13 13 14 13 13 13 13 13 
38 38 38 33 13 14 37 38 38 38 38 38 38 38 38 38 38 38 38 38 38 38 38 38 38 38 38 38 38 38 38 38 38 38 38 55 13 13 13 13 13 13 13 13 13 13 13 13 13 13 
38 38 38 33 19 13 37 38 38 38 38 38 38 38 38 38 38 38 38 38 38 38 38 38 38 38 38 38 38 38 38 38 38 38 38 33 13 13 41 41 41 41 41 41 41 41 42 13 13 19 
38 38 38 31 30 30 32 38 38 38 38 38 38 38 38 38 38 38 38 38 38 38 38 38 38 38 38 38 38 38 38 38 38 38 38 31 30 30 30 30 30 30 30 30 30 30 30 30 30 30 
