20 20 20 20 20 20 2 0 0 0 0 0 0 0 0 0 0 0 0 0 37 20 20 20 20 20 20 20 20 20 20 20 20 20 20 20 20 20 20 43 0 0 0 0 0 0 0 0 0 0 
20 20 20 20 20 20 2 8 9 9 9 9 9 9 9 9 9 9 9 9 39 20 20 20 20 20 20 20 20 20 20 20 20 20 20 20 20 20 20 45 9 9 9 9 9 9 9 9 9 9 
20 20 20 20 20 20 2 15 16 7 16 16 16 16 16 16 16 16 16 16 40 0 0 0 0 0 0 20 20 20 20 20 20 43 0 0 0 0 0 42 16 16 7 16 16 16 16 16 12 16 
20 20 20 20 20 20 2 15 16 16 14 16 16 16 16 16 16 7 16 16 31 9 9 9 9 9 10 20 20 20 20 20 20 45 9 9 9 9 9 32 16 16 16 16 16 16 16 16 16 16 
20 20 2 0 0 0 0 15 16 16 16 16 16 16 16 16 16 16 16 16 16 16 16 16 16 16 17 0 0 0 0 0 0 44 16 16 16 16 16 16 16 16 16 7 7 16 16 16 16 16 
20 20 2 8 9 9 9 32 16 16 16 16 16 16 16 16 16 16 16 13 16 16 7 16 16 16 31 9 9 9 9 9 9 32 7 16 16 16 16 16 16 16 16 16 16 16 16 16 16 16 
20 20 2 15 16 16 16 16 16 16 16 16 16 16 16 16 16 16 16 16 16 16 16 16 16 16 16 16 16 16 16 16 16 16 16 16 16 16 16 16 16 16 16 16 16 16 16 16 16 16 
20 20 2 15 16 16 16 7 16 16 7 16 16 16 16 7 16 16 16 16 16 16 16 16 16 16 16 16 16 16 16 16 16 16 16 16 16 16 14 16 16 16 16 16 16 16 16 16 16 16 
0 0 0 15 16 16 16 16 16 16 16 16 16 16 16 16 16 16 16 16 16 16 16 16 16 16 16 16 16 16 16 16 16 16 16 16 16 16 16 16 16 16 16 16 16 16 16 16 16 16 
8 9 9 32 16 16 16 16 16 16 16 16 16 16 16 7 16 16 16 7 16 16 16 16 12 7 31 16 16 16 16 16 16 16 16 16 16 16 16 16 16 16 16 7 7 16 16 16 16 16 
15 7 16 7 16 16 16 16 16 7 16 16 16 16 16 16 16 16 16 16 16 16 16 16 16 7 16 16 16 7 16 16 16 16 16 16 16 16 16 16 7 16 16 16 16 16 16 16 16 16 
42 16 16 16 16 16 16 16 16 16 16 16 16 16 16 16 16 16 16 16 16 16 16 16 16 16 16 16 16 16 16 16 16 16 16 16 16 16 16 16 16 16 16 16 16 16 16 16 16 16 
42 16 16 16 16 7 16 16 16 16 16 16 16 16 16 16 16 16 16 16 16 16 16 16 16 16 16 16 16 16 16 16 16 7 16 16 16 16 16 16 16 16 16 16 16 16 16 16 13 16 
42 16 16 16 16 14 16 16 16 16 7 16 16 16 16 12 16 16 16 16 7 16 16 16 16 16 16 16 16 16 16 16 16 16 16 16 16 16 16 16 16 16 16 16 16 16 16 16 16 16 
42 16 16 16 16 16 16 16 16 16 7 16 16 16 16 16 16 16 16 16 16 16 16 16 16 7 16 16 16 16 16 16 16 12 16 16 16 16 7 16 16 16 7 16 16 16 16 16 16 16 
5 5 5 42 16 16 16 16 16 16 16 16 16 16 16 16 16 16 16 16 16 16 16 16 16 16 16 16 16 16 16 16 16 16 16 16 16 16 16 16 16 16 16 16 16 16 16 7 16 24 
20 20 20 42 16 16 16 16 16 16 16 16 16 16 16 16 16 7 16 16 16 16 16 16 13 16 40 5 5 5 5 5 5 42 16 16 16 16 16 16 16 14 16 7 16 16 16 16 24 5 
20 20 20 42 16 16 16 16 16 7 16 16 16 16 16 16 16 16 16 16 29 23 23 23 23 23 47 20 20 20 20 20 20 46 23 23 23 23 23 30 16 16 16 16 16 16 16 24 5 20 
20 20 20 42 16 16 16 16 16 16 16 13 16 16 16 16 16 16 16 16 40 5 5 5 5 5 5 20 20 20 20 20 20 5 5 5 5 5 5 42 16 16 7 16 16 16 24 5 20 20 
20 20 20 42 16 16 16 16 16 16 16 16 16 16 7 16 16 16 16 16 40 20 20 20 20 20 20 20 20 20 20 20 20 20 20 20 20 20 20 42 16 16 16 16 16 24 5 20 20 20 
20 20 20 46 23 23 23 23 23 23 23 23 23 23 23 23 23 23 23 23 47 20 20 20 20 20 20 20 20 20 20 20 20 20 20 20 20 20 20 46 23 23 23 23 23 5 20 20 20 20 
20 20 20 5 5 5 5 5 5 5 5 5 5 5 5 5 5 5 5 5 5 20 20 20 20 20 20 20 20 20 20 20 20 20 20 20 20 20 20 5 5 5 11 11 11 20 20 20 20 20 
20 20 20 20 20 20 20 20 20 20 20 20 20 20 20 20 20 20 20 20 20 20 20 20 20 20 20 20 20 20 20 20 20 20 20 20 20 20 20 20 20 20 11 11 11 20 20 20 20 20 
20 20 20 20 20 20 20 20 20 20 20 20 20 20 20 20 20 20 20 20 20 20 20 20 20 20 20 20 20 20 20 20 20 20 20 20 20 20 20 20 20 20 11 11 11 20 20 20 20 20 
20 20 43 0 0 0 0 0 0 0 0 0 0 0 0 0 0 0 3 20 20 20 20 20 20 20 20 20 20 20 20 20 20 20 20 20 2 43 0 0 0 0 11 11 11 0 0 0 0 0 
20 43 45 9 9 9 9 9 9 9 9 9 9 9 9 9 9 10 37 20 20 20 20 20 20 20 20 20 20 20 20 20 20 20 20 2 43 8 9 9 9 10 11 11 11 8 9 9 9 9 
43 45 16 14 16 16 16 16 16 16 16 16 16 16 16 16 16 31 10 5 0 0 0 0 0 0 0 0 0 0 0 0 0 0 0 0 8 32 16 16 16 16 16 16 16 16 16 16 16 12 
45 16 16 16 7 16 16 16 16 16 16 16 16 7 16 16 16 16 31 9 9 9 9 9 9 9 9 9 9 9 9 9 9 9 9 9 32 16 16 16 16 16 16 16 16 16 7 16 16 24 
46 23 30 16 16 16 16 16 16 16 16 16 16 16 16 16 16 16 16 16 16 16 16 16 16 16 16 16 16 16 16 16 16 16 16 32 16 16 7 16 16 16 16 16 16 16 16 16 24 43 
5 5 46 16 16 16 16 16 7 16 16 16 16 16 16 16 16 16 16 16 16 16 16 16 16 16 16 16 16 16 16 16 16 16 16 16 16 16 7 16 16 16 7 16 16 16 16 24 43 20 
20 20 5 46 16 16 16 16 7 16 12 16 16 16 16 16 16 16 16 16 7 7 16 16 16 16 16 7 16 16 16 16 16 16 16 16 14 16 16 16 16 16 7 16 16 16 24 43 20 20 
20 20 20 5 46 23 23 23 23 23 23 23 23 23 23 23 23 23 23 23 23 23 23 23 23 23 23 23 23 23 23 23 23 23 23 23 23 23 23 23 23 23 23 23 23 24 43 20 20 20 
20 20 20 20 5 11 11 11 5 5 5 5 5 5 5 5 5 5 5 5 5 5 5 5 5 5 5 5 5 5 5 5 5 5 5 5 5 5 5 5 5 5 5 5 5 5 20 20 20 20 
20 20 20 20 20 11 11 11 20 20 20 20 20 20 20 20 20 20 20 20 20 20 20 20 20 20 20 20 20 20 20 20 20 20 20 20 20 20 20 20 20 20 20 20 20 20 20 20 20 20 
20 20 20 20 20 11 11 11 20 20 20 20 20 20 20 20 20 20 20 20 20 20 20 20 20 20 20 20 20 20 20 20 20 20 20 20 20 20 20 20 20 20 20 20 20 20 20 20 20 20 
43 0 0 0 0 11 11 11 0 0 0 0 0 3 20 20 20 20 20 20 20 20 20 20 20 2 0 0 0 0 0 0 0 0 0 0 0 0 0 0 0 0 0 0 0 0 0 37 20 20 
45 9 9 9 10 11 11 11 8 9 9 9 10 3 20 20 20 20 20 20 20 20 20 20 2 43 8 9 9 9 9 9 9 9 9 9 9 9 9 9 9 9 9 9 9 9 9 39 20 20 
42 12 16 16 16 16 16 16 16 16 16 16 17 3 20 20 20 20 20 20 20 20 20 2 43 8 16 16 12 16 16 16 16 16 16 16 16 16 16 16 16 16 16 16 16 16 16 38 20 20 
42 16 16 16 16 16 16 16 16 7 16 16 17 3 20 20 20 20 20 20 20 20 2 43 8 16 16 16 16 16 16 16 16 7 16 16 16 16 16 16 16 16 14 16 16 16 16 41 18 37 
42 16 16 16 7 16 16 16 16 16 16 16 41 0 0 0 0 0 0 0 0 0 0 8 16 16 16 16 16 16 16 16 16 16 16 16 16 16 16 16 16 7 16 16 16 16 16 31 9 39 
42 16 16 16 16 16 16 16 16 16 16 16 31 9 9 9 9 9 9 9 9 9 9 16 16 16 16 7 16 16 16 16 16 16 16 16 7 16 16 16 16 16 16 16 16 16 16 16 16 40 
46 23 23 30 16 16 16 16 16 16 16 16 14 16 16 16 16 16 16 16 16 16 16 7 16 16 16 16 16 16 16 16 16 16 16 16 16 16 16 16 16 16 16 16 16 16 16 7 16 40 
5 5 5 42 16 13 16 16 16 16 16 16 16 16 16 16 31 16 16 16 16 16 16 16 16 16 16 16 16 16 16 16 16 13 16 16 16 16 16 16 16 16 16 16 16 16 16 16 16 40 
20 20 20 42 16 16 16 7 16 16 16 16 16 16 16 16 7 16 16 16 7 16 16 16 16 16 16 16 16 16 7 16 16 16 16 16 16 16 16 16 16 16 16 7 16 16 16 16 16 40 
20 20 20 42 16 16 16 16 16 16 16 16 16 16 7 16 16 16 16 16 16 16 16 16 16 7 7 16 16 16 16 16 16 16 16 7 16 16 16 16 16 16 16 16 16 16 16 16 16 24 
20 20 20 46 23 23 23 23 30 16 16 16 16 16 16 16 16 16 16 16 16 16 14 16 16 16 16 16 16 16 16 16 16 16 16 16 16 16 16 16 16 12 16 16 16 29 23 23 24 43 
20 20 20 5 5 5 5 5 42 16 16 12 16 16 16 16 16 16 7 7 16 16 16 16 16 16 16 16 16 13 16 16 16 16 16 16 16 16 16 16 16 16 16 16 16 17 43 5 5 20 
20 20 20 20 20 20 20 20 22 23 23 23 23 23 23 23 23 23 23 23 23 23 23 23 23 23 23 23 23 23 23 23 23 23 23 23 23 23 23 23 23 30 16 16 16 17 3 20 20 20 
20 20 20 20 20 20 20 35 5 5 5 5 5 5 5 5 5 5 5 5 5 5 5 5 5 5 5 5 5 5 5 5 5 5 5 5 5 5 5 5 5 46 16 7 16 24 3 20 20 20 
20 20 20 20 20 20 20 20 20 20 20 20 20 20 20 20 20 20 20 20 20 20 20 20 20 20 20 20 20 20 20 20 20 20 20 20 20 20 20 20 20 37 16 16 16 43 20 20 20 20 
