29 28 28 28 28 28 28 28 28 7 8 9 8 3 28 28 27 28 28 28 28 28 28 28 28 28 28 38 28 28 28 28 28 30 31 28 28 28 28 28 28 28 28 28 28 28 28 28 28 28 
29 28 28 27 28 28 28 28 28 7 8 8 8 3 28 28 28 28 28 28 28 28 28 28 27 28 28 38 28 28 28 28 28 30 31 28 28 28 27 28 28 28 28 28 28 27 28 28 28 28 
29 28 28 28 27 27 28 28 28 7 9 8 9 3 28 28 28 28 28 28 28 28 28 28 28 28 28 38 28 28 28 28 28 30 31 28 28 28 27 28 27 28 28 28 28 28 28 28 28 28 
29 28 28 28 28 28 28 28 28 7 8 8 8 3 28 28 28 28 28 28 28 28 28 28 28 28 14 16 28 27 28 28 28 30 31 28 28 28 28 28 27 27 28 28 28 28 28 28 28 28 
15 14 28 27 28 28 28 28 28 7 8 9 8 3 28 28 28 28 27 28 28 28 28 28 27 38 13 13 27 28 28 28 28 30 31 28 28 28 28 28 28 28 28 28 27 28 28 28 28 28 
13 13 15 14 28 28 28 28 28 28 5 5 5 28 28 28 28 28 28 28 28 28 28 28 14 16 13 13 28 28 28 28 28 30 31 28 28 27 27 28 28 28 28 28 28 28 28 27 28 28 
13 13 13 13 29 28 28 28 28 28 28 28 28 28 28 27 28 28 27 27 28 28 28 38 13 13 13 13 28 28 28 28 28 30 31 28 28 28 27 28 28 28 28 28 28 27 28 28 28 28 
13 13 13 13 29 28 28 27 28 27 28 28 27 28 28 28 28 28 28 28 28 28 14 16 13 13 13 13 28 28 28 28 28 30 31 28 28 28 28 28 28 28 28 28 28 28 28 28 28 28 
13 13 13 13 15 14 28 27 27 28 28 28 28 28 28 27 28 28 28 14 14 16 13 13 13 13 10 12 28 28 28 28 28 30 31 28 28 28 1 1 1 1 1 1 1 1 28 28 28 28 
11 10 13 13 13 13 29 28 28 28 27 27 27 28 28 28 14 14 16 13 13 13 13 13 13 13 28 27 28 28 33 35 35 23 31 28 28 4 20 19 19 19 19 19 19 21 6 28 28 28 
28 28 11 10 13 13 29 28 28 28 28 28 28 28 14 16 13 13 13 13 13 13 13 13 11 12 28 27 28 28 30 25 25 25 26 28 4 20 18 8 8 8 8 8 9 17 21 6 28 28 
28 28 28 28 13 13 15 14 28 28 28 28 28 38 13 13 13 13 13 13 13 13 13 13 28 28 27 27 28 28 30 31 28 28 28 4 20 18 8 8 8 8 8 8 8 8 17 21 6 28 
28 27 28 28 13 13 13 13 15 14 37 37 14 16 13 13 13 13 13 13 13 13 11 12 28 28 28 28 28 28 30 31 28 28 7 20 18 8 8 8 8 9 8 8 8 8 8 17 21 3 
28 28 28 28 11 10 13 13 13 13 37 37 13 13 13 13 13 13 13 10 10 10 28 28 28 28 28 28 33 35 23 26 28 28 7 22 8 8 8 8 8 8 8 8 8 9 8 8 22 3 
28 28 28 28 28 28 13 13 13 13 37 37 13 13 13 13 11 10 12 28 28 28 27 27 28 28 28 33 23 25 26 28 28 28 7 22 8 8 8 8 8 8 8 8 8 8 8 8 22 3 
28 28 28 27 28 28 13 13 13 13 37 37 13 13 10 12 28 28 28 28 28 27 28 28 28 28 28 23 23 28 28 28 28 28 7 22 8 8 8 8 8 8 8 8 8 8 8 8 22 3 
27 28 28 28 28 28 11 10 13 13 37 37 13 13 28 28 28 28 28 28 28 28 28 28 28 28 28 23 23 28 28 28 28 28 7 22 9 8 8 8 8 8 8 8 8 8 8 8 22 3 
28 28 28 28 28 28 28 28 11 10 37 37 10 12 28 28 28 27 27 27 27 28 28 28 33 35 35 23 31 28 28 28 27 28 7 22 8 8 8 8 9 8 8 8 8 8 8 8 22 3 
28 28 28 28 27 28 28 28 7 8 37 37 8 3 28 28 28 28 28 28 27 27 28 28 30 23 25 25 26 28 28 28 28 28 7 22 8 8 8 8 8 8 8 8 8 8 8 9 22 3 
28 28 27 28 27 28 28 28 7 8 37 37 8 3 28 28 28 28 28 28 28 27 28 28 30 31 28 28 28 28 28 28 28 28 7 22 8 8 8 8 8 8 8 8 8 8 8 8 22 3 
28 28 27 28 27 28 28 28 4 8 37 37 8 6 28 28 28 28 27 28 28 27 28 28 30 31 28 28 28 28 28 27 28 28 7 17 21 8 9 8 8 8 8 8 8 8 8 20 18 3 
28 28 28 28 28 28 28 4 8 8 8 9 8 8 6 28 28 28 27 28 28 27 28 28 30 31 28 28 28 27 27 27 28 28 28 2 17 19 19 19 19 8 8 19 19 19 19 18 0 28 
28 28 28 28 28 28 4 8 8 8 8 9 8 8 8 6 28 28 27 27 27 27 28 28 30 31 28 28 27 28 28 28 28 28 28 28 5 5 5 5 2 8 8 0 5 5 5 5 28 28 
28 28 27 28 28 7 8 8 9 8 8 8 8 8 8 8 3 28 28 28 28 28 28 28 30 31 28 28 28 28 28 28 28 28 28 27 28 28 28 28 7 8 8 6 28 28 27 27 28 28 
28 28 28 28 28 7 8 8 8 8 8 8 8 8 8 8 3 28 28 28 28 28 28 28 30 31 28 28 28 28 28 28 28 28 28 28 28 28 28 28 7 8 8 8 6 28 28 28 27 28 
27 28 28 28 28 7 8 8 8 8 8 8 8 9 8 8 3 28 28 33 35 35 35 35 23 23 35 35 34 28 28 28 27 27 28 28 28 28 27 28 28 2 8 9 8 6 28 28 28 28 
27 27 28 27 28 7 8 8 8 8 8 8 8 8 8 8 3 28 33 23 23 23 23 23 23 23 23 23 31 28 28 28 28 28 28 28 28 28 28 28 28 28 2 8 8 8 6 28 28 28 
28 28 27 27 28 28 5 2 8 8 8 8 8 8 0 5 28 33 23 23 23 23 23 23 23 23 23 23 23 35 34 28 28 28 28 28 28 28 28 27 28 28 28 2 8 8 8 6 28 27 
28 28 27 28 28 28 28 28 28 2 8 8 0 28 28 28 33 23 23 23 23 23 23 23 23 23 23 23 23 23 31 28 28 27 28 27 28 28 28 28 1 1 1 28 2 8 8 8 3 28 
28 28 28 28 27 28 28 28 28 7 8 9 3 28 28 28 30 23 23 23 23 23 23 23 23 23 23 23 23 23 31 28 28 28 28 28 28 28 28 4 8 8 9 3 28 2 8 9 3 28 
28 28 28 28 28 28 28 28 28 7 8 8 3 28 27 27 30 23 23 23 23 23 23 23 23 23 23 23 23 23 31 28 28 28 27 28 28 28 4 8 8 8 8 6 1 4 8 8 3 28 
28 28 28 28 28 28 28 28 28 7 8 8 3 28 28 28 30 23 23 23 23 23 23 23 23 23 23 23 23 23 31 28 28 28 28 28 28 7 9 8 0 2 8 8 8 8 9 8 3 28 
27 28 28 28 27 28 28 28 28 7 9 8 3 28 28 28 30 23 23 23 23 23 23 23 23 23 23 23 23 23 26 28 28 28 27 28 28 7 8 8 3 28 2 9 8 8 8 0 28 28 
27 28 28 28 27 28 28 28 28 7 8 8 3 28 27 28 30 23 23 23 23 23 23 23 23 23 23 23 23 26 28 28 28 28 27 28 28 7 8 8 6 28 28 5 5 5 5 28 28 28 
27 28 28 28 28 28 28 28 28 7 8 8 3 28 27 28 30 23 23 23 23 23 23 23 23 23 23 23 26 28 28 27 28 28 27 28 28 28 2 8 8 6 28 28 28 28 28 28 28 28 
27 28 28 28 28 27 27 28 28 7 8 8 3 28 28 28 24 25 25 25 25 25 25 25 25 25 25 26 28 28 27 28 28 28 28 28 1 1 1 2 8 8 3 28 27 28 28 28 28 28 
28 28 28 27 28 28 27 28 28 7 8 9 3 28 28 28 28 28 28 27 27 27 27 28 27 27 28 28 28 27 27 28 28 28 28 4 8 8 8 8 9 8 3 28 27 28 28 28 28 28 
28 28 28 28 27 28 28 28 28 7 8 8 3 28 28 28 28 28 28 28 28 27 28 28 28 28 28 28 28 28 28 28 28 28 4 8 9 8 8 8 8 0 28 28 28 28 28 28 28 28 
28 27 27 28 28 27 27 28 28 7 8 8 6 1 1 1 1 1 1 1 1 1 1 1 1 1 1 1 1 1 1 1 1 4 8 8 0 5 5 5 5 28 28 28 28 28 28 27 28 28 
28 28 28 28 28 28 27 28 28 7 8 8 8 8 8 8 9 8 8 8 8 9 8 8 8 8 8 9 8 8 8 8 8 8 8 0 28 28 28 28 28 28 28 28 28 28 28 27 28 28 
28 28 28 28 28 28 28 28 28 28 2 9 8 8 8 8 8 8 8 9 8 8 8 8 9 8 8 8 8 8 8 8 9 8 0 28 28 28 28 28 28 27 27 28 28 28 28 28 28 28 
28 28 28 28 28 28 28 28 28 28 28 5 5 5 5 5 5 5 5 5 5 5 5 2 8 8 0 5 5 5 5 5 5 5 28 28 28 27 27 28 28 28 28 28 28 28 28 28 28 28 
28 28 28 27 28 28 28 28 28 28 28 28 28 28 28 28 28 28 28 28 28 28 28 7 8 8 3 28 28 28 28 28 28 28 28 28 27 27 28 28 28 28 28 28 28 28 28 28 28 28 
28 28 27 27 28 28 28 28 28 28 28 28 27 28 27 28 28 28 28 28 28 28 28 7 8 8 3 28 28 27 28 28 28 28 28 27 28 28 28 28 28 28 28 28 27 28 28 28 28 28 
28 28 28 28 28 28 28 28 28 28 28 28 28 28 28 28 28 28 28 27 28 28 28 7 9 8 3 28 28 28 28 28 28 28 28 28 28 28 27 28 28 28 28 28 27 28 28 28 28 28 
27 28 28 28 27 27 28 28 27 27 28 28 28 28 28 28 28 28 28 28 27 28 28 7 8 8 3 28 28 28 27 28 28 28 28 27 27 27 28 27 28 27 27 27 27 28 28 27 28 28 
27 27 27 28 28 28 28 28 28 27 27 27 28 28 28 28 27 28 28 28 28 28 28 7 8 8 3 28 28 28 27 27 27 27 28 28 27 27 28 28 28 28 28 28 28 28 28 27 28 28 
28 28 27 28 28 28 27 28 28 28 28 28 27 27 27 28 28 28 28 28 27 28 28 7 8 8 3 28 28 28 28 28 28 28 27 27 28 28 28 28 28 28 28 27 28 28 28 28 28 28 
28 28 27 28 28 27 27 28 28 28 28 28 28 28 28 28 28 28 27 27 27 28 28 7 9 8 3 28 28 28 28 28 28 28 28 28 27 27 27 28 28 28 28 28 28 28 28 28 28 28 
28 28 27 27 27 28 28 28 28 28 28 28 28 28 28 28 28 28 28 27 27 28 28 7 8 8 3 28 28 28 28 28 28 28 28 28 28 28 28 28 28 28 28 28 28 28 28 28 28 28 
