0 1 1 1 1 1 1 1 1 1 1 1 1 1 1 1 1 1 1 2
3 4 9 5 6 6 6 6 6 6 6 6 6 6 6 6 6 6 6 7
3 9 4 8 6 6 6 6 6 6 6 6 6 6 6 6 6 6 6 7
3 5 8 6 6 6 6 6 6 6 6 6 6 6 6 6 6 6 6 7
3 6 6 6 6 6 6 6 6 6 6 6 6 6 6 6 6 6 6 7
3 6 6 6 6 6 6 6 6 6 6 6 6 6 6 6 6 6 6 7
3 6 6 6 6 6 6 6 6 6 6 6 6 6 6 6 6 6 6 7
3 6 6 6 6 6 6 6 6 6 6 6 6 6 6 6 6 6 6 7
3 6 6 6 6 6 6 6 6 6 6 6 6 6 6 6 6 5 8 7
3 8 5 6 6 6 6 6 6 6 6 6 6 6 6 6 5 9 4 7
3 5 8 6 6 6 6 6 6 6 6 6 6 6 6 6 8 4 9 7
10 11 11 11 11 11 11 11 6 6 6 6 11 11 11 11 11 11 11 13