4 4 4 4 4 4 4 4 4 4 5 9 9 9 9 9 9 9 9 9 9 9 9 9 27 32 28 9 9 9 9 9 9 9 9 9 9 9 9 9 42 43 43 43 51 50 43 43 18 43 
32 31 18 51 52 1 1 32 32 18 51 5 9 9 9 9 9 9 9 9 9 9 9 9 27 18 28 9 9 9 9 9 9 9 9 9 9 9 9 42 32 32 31 18 32 32 32 31 18 18 
32 32 18 32 17 7 7 16 32 32 50 31 5 9 9 9 9 9 9 9 9 9 9 26 32 32 52 25 9 9 9 9 9 9 9 9 9 9 42 32 32 18 32 32 32 18 32 32 52 51 
32 18 32 6 7 7 7 7 16 32 32 18 46 9 9 9 9 9 9 9 9 9 26 32 31 0 1 1 25 9 9 9 9 9 9 9 9 9 51 18 32 32 32 1 1 1 32 18 32 32 
32 31 51 6 7 7 7 7 7 8 32 32 46 9 9 9 9 9 9 9 9 26 32 52 32 6 7 7 16 25 9 9 9 9 9 9 9 9 50 32 32 32 17 7 7 7 16 32 18 32 
32 32 52 17 7 7 7 7 7 8 32 18 46 9 9 9 9 9 9 9 26 51 32 32 32 32 14 7 7 16 25 9 9 9 9 9 9 9 45 31 32 17 7 7 7 7 7 16 32 32 
32 18 6 7 7 7 7 7 7 8 32 18 46 9 9 9 9 9 9 26 32 50 31 32 32 32 18 14 7 7 8 25 9 9 9 9 9 9 45 51 17 7 7 7 7 7 7 7 16 32 
32 32 6 7 7 7 7 7 7 8 32 32 46 9 9 9 9 9 26 32 32 32 18 32 1 32 32 18 14 7 8 32 25 9 9 9 9 9 45 6 7 7 7 7 7 7 7 7 7 8 
18 32 17 7 7 7 7 7 7 8 32 51 46 9 9 9 9 26 32 50 32 32 32 32 17 7 16 32 32 11 12 32 32 25 9 9 9 9 45 6 7 7 7 7 7 7 7 7 7 8 
32 6 7 7 7 7 7 7 7 8 32 50 52 9 9 9 26 32 51 50 32 32 32 17 7 7 7 16 32 32 52 31 32 32 25 9 9 9 45 6 7 7 7 7 7 7 7 7 7 8 
18 6 7 7 7 7 7 7 7 8 32 31 46 9 9 26 32 32 32 32 51 32 17 7 7 7 7 7 16 18 51 50 32 32 32 25 9 9 45 18 14 7 7 7 7 7 7 7 13 51 
32 31 14 7 7 7 7 7 13 32 32 48 49 9 9 27 32 32 32 32 32 17 7 7 7 7 7 7 7 16 32 32 32 32 32 28 9 9 45 51 50 14 7 7 7 7 7 13 18 52 
47 32 18 14 7 7 7 13 18 18 46 19 19 9 9 27 52 51 32 32 17 7 7 7 7 7 7 7 7 7 16 32 32 31 32 28 9 9 47 48 18 52 14 7 7 7 13 32 32 31 
19 47 32 50 11 11 11 32 32 48 49 19 19 9 9 27 50 32 32 17 7 7 7 7 7 7 7 7 7 7 7 16 32 52 51 28 9 9 19 19 45 18 31 11 11 11 32 18 32 32 
19 19 45 50 50 18 32 32 46 19 19 19 19 9 9 27 32 32 32 14 7 13 11 14 7 7 7 13 11 14 7 13 18 32 50 28 9 9 19 19 47 48 32 32 18 32 32 51 31 48 
19 19 47 48 51 32 32 48 49 19 19 19 19 9 9 27 32 32 32 10 11 12 32 6 7 7 7 8 32 10 11 12 32 32 32 28 9 9 19 19 19 19 45 32 32 18 32 32 46 19 
19 19 19 19 34 40 35 19 19 19 19 22 22 9 9 27 32 18 51 32 32 32 32 6 7 7 7 8 50 51 32 32 32 32 32 28 9 9 19 19 19 19 47 48 34 40 35 48 49 19 
19 19 19 19 36 33 37 19 19 19 19 9 9 9 9 27 51 32 32 32 32 32 32 6 7 7 7 8 18 50 32 32 32 18 32 28 9 9 19 19 19 19 19 19 36 33 37 19 19 19 
22 19 19 19 36 33 37 19 19 22 22 9 9 9 9 27 52 50 32 32 32 32 32 6 7 7 7 8 32 0 1 2 32 32 32 28 9 9 22 22 19 19 19 19 36 33 37 19 19 19 
9 22 19 19 36 33 37 19 19 9 9 9 9 9 9 27 32 32 31 17 7 16 1 17 7 7 7 16 1 17 7 16 32 32 31 28 9 9 9 9 19 19 19 19 36 33 37 19 19 22 
9 9 19 19 36 33 37 19 19 9 9 9 9 9 9 20 32 32 32 14 7 7 7 7 7 7 7 7 7 7 7 13 51 50 32 24 9 9 9 9 22 22 19 19 36 33 37 19 19 9 
9 9 22 22 36 33 37 22 22 9 9 9 9 9 9 9 20 32 32 32 14 7 7 7 7 7 7 7 7 7 13 18 52 32 24 9 9 9 9 9 9 9 22 22 36 33 37 22 22 9 
9 9 9 9 38 41 39 9 9 9 9 9 9 9 9 9 9 20 32 52 32 14 7 7 7 7 7 7 7 13 32 51 32 24 9 9 9 9 9 9 9 9 9 9 38 41 39 9 9 9 
9 9 9 9 27 32 28 9 9 9 9 9 9 9 9 9 9 9 20 32 32 32 14 7 7 7 7 7 13 32 18 32 24 9 9 9 9 9 9 9 9 9 9 9 27 32 28 9 9 9 
9 9 9 9 27 32 28 9 9 9 9 9 9 9 9 9 9 9 9 20 18 32 32 14 7 7 7 13 52 32 32 24 9 9 9 9 9 9 9 9 9 9 9 9 27 32 28 9 9 9 
9 9 9 9 27 18 28 9 9 9 9 9 9 9 9 9 9 9 9 9 20 32 31 32 14 7 13 32 32 32 24 9 9 9 9 9 9 9 9 9 9 9 9 9 27 31 28 9 9 9 
9 9 9 9 27 31 28 9 9 9 9 9 9 9 9 9 9 9 9 9 9 20 32 32 10 11 12 32 51 24 9 9 9 9 9 9 9 9 9 9 9 9 9 9 27 18 28 9 9 9 
9 9 9 9 27 32 28 9 9 9 9 9 9 9 9 9 9 9 9 9 9 9 20 32 32 32 32 31 24 9 9 9 9 9 9 9 9 9 9 9 9 9 9 9 27 32 28 9 9 9 
9 9 9 9 27 32 28 9 9 9 9 9 9 9 9 9 9 9 9 9 9 9 9 20 32 32 32 24 9 9 9 9 9 9 9 9 9 9 9 9 9 9 9 9 27 32 28 9 9 9 
9 9 9 9 27 18 28 9 9 9 9 9 9 9 9 9 26 29 29 29 29 29 29 29 32 18 32 29 29 29 29 29 29 29 25 9 9 9 9 9 9 9 9 9 27 18 28 9 9 9 
9 9 9 9 27 32 28 9 9 9 9 9 9 9 9 26 32 32 32 51 32 32 32 52 32 32 32 32 31 51 18 32 32 32 32 25 9 9 9 9 9 9 9 9 27 18 28 9 9 9 
9 9 9 9 27 32 28 9 9 9 9 9 9 9 26 32 18 31 32 18 32 0 1 1 1 1 1 1 1 2 32 32 32 32 32 32 25 9 9 9 9 9 9 26 32 32 28 9 9 9 
9 9 9 9 27 32 32 25 9 9 9 9 9 26 32 32 50 32 32 32 32 6 7 7 7 7 7 7 7 8 32 32 32 18 32 32 32 25 9 9 9 9 26 32 31 32 28 9 9 9 
9 9 9 9 27 51 31 32 29 29 29 29 29 18 32 32 32 32 18 32 32 6 7 7 7 7 7 7 7 8 32 18 32 32 32 32 32 32 29 29 29 29 32 32 18 51 28 9 9 9 
9 9 9 9 20 32 50 18 32 32 32 18 32 32 32 32 32 32 32 32 32 6 7 7 7 7 7 7 7 8 32 32 18 32 31 18 32 18 18 32 32 18 31 32 30 30 24 9 9 9 
25 9 9 9 9 20 30 30 30 30 30 30 30 32 32 32 18 32 32 32 32 6 7 7 7 7 7 7 7 8 32 32 18 32 51 50 32 32 30 30 30 30 30 24 9 9 9 9 9 26 
32 25 9 9 9 9 9 9 9 9 9 9 9 20 32 51 50 32 32 32 32 6 7 7 7 7 7 7 7 8 18 32 18 32 32 32 32 24 9 9 9 9 9 9 9 9 9 9 26 31 
32 32 25 9 9 9 9 9 9 9 9 9 9 9 20 32 51 32 32 32 32 6 7 7 7 7 7 7 7 8 32 51 32 32 32 32 24 9 9 9 9 9 9 9 9 9 9 26 32 52 
18 51 32 25 9 9 9 9 9 9 9 9 9 9 9 20 32 32 32 32 18 10 11 11 11 11 11 11 11 12 50 52 32 32 32 24 9 9 9 9 9 9 9 9 9 9 26 32 18 51 
50 50 31 32 25 9 9 9 9 9 9 9 9 9 9 9 20 30 30 30 30 30 30 32 32 32 32 32 30 30 30 30 30 30 24 9 9 9 9 9 9 9 9 9 9 26 32 32 32 32 
32 32 32 32 32 25 9 9 9 9 9 9 9 9 9 9 9 9 9 9 9 9 9 20 32 32 32 24 9 9 9 9 9 9 9 9 9 9 9 9 9 9 9 9 26 32 32 0 1 2 
32 18 32 32 50 32 25 9 9 9 9 9 9 9 9 9 9 9 9 9 9 9 9 9 27 32 28 9 9 9 9 9 9 9 9 9 9 9 9 9 9 9 9 26 32 31 1 17 7 8 
32 32 32 32 32 51 32 29 29 29 29 29 29 29 29 29 29 29 29 29 29 29 29 29 32 18 32 29 29 29 29 29 29 29 29 29 29 29 29 29 29 29 29 18 52 17 7 7 7 8 
32 0 1 1 2 32 31 18 32 30 30 30 30 30 30 30 30 30 30 30 30 30 30 30 32 32 51 30 30 30 30 30 30 30 30 30 30 30 30 30 30 30 32 51 17 7 7 7 7 8 
32 6 7 7 16 32 32 32 32 25 9 9 9 9 9 9 9 9 9 9 9 9 9 26 32 32 52 25 9 9 9 9 9 9 9 9 9 9 9 9 9 26 32 6 7 7 7 7 7 8 
32 32 14 7 7 16 2 32 32 32 25 9 9 9 9 9 9 9 9 9 9 9 26 32 32 32 18 32 25 9 9 9 9 9 9 9 9 9 9 9 26 32 32 10 11 11 14 7 7 8 
32 32 32 14 7 7 8 32 32 18 32 25 9 9 9 9 9 9 9 9 9 26 32 32 0 1 2 32 32 25 9 9 9 9 9 9 9 9 9 26 32 32 32 32 32 0 17 7 7 8 
32 51 32 32 14 7 8 32 32 32 32 32 25 9 9 9 9 9 9 9 26 32 32 32 17 7 16 32 31 32 25 9 9 9 9 9 9 9 26 32 32 32 18 32 32 6 7 7 7 8 
18 50 52 32 10 11 12 32 32 32 52 32 32 25 9 9 9 9 9 26 32 51 32 17 7 7 7 16 32 18 32 25 9 9 9 9 9 26 32 32 32 52 31 32 32 6 7 13 11 51 
32 32 32 31 32 32 32 32 32 32 18 51 32 32 25 9 9 9 26 32 18 32 17 7 7 7 7 7 16 32 32 31 25 9 9 9 26 32 32 32 18 51 50 32 32 10 11 12 50 50 
